1111111111111111111111111111111111
10000000000000C00000C0000000000011
1010010100100000101001000000010101
1010010100100000101001000000010101
1010010100100000101001000000010101
1010010100100000101001000000010101
1P0000000C00C0000000000000000000C1
1010010100100000101001000000010101
1010010100100000101001000000010101
1010010100100000101001000000010101
1010010100100000101001000000010101
1010010100100000101001000000010101
1010010100100C00101001000000010101
1010010100100C00101001000000010111
1C1000CC001000010000CC1110001100E1
1111111111111111111111111111111111
